1111111
1P0C001
100C001
10E0001
1111111
