1111111111111
10P0001C000E1
1000001111001
1000C00011001
1000110000001
1000010001001
1111111111111