1111111111111
1000001C00001
1000001111001
1000C00011001
1000110000001
1000010001001
1111111111111