1111111111
1P000000C1
1110000011
1C11111101
1000000001
1111111111