111111111111111111111111111111111111111111
1P0000000010000000000000100000000000000011
101111101010111111111110101111111111101011
100000001010000000000010000000000000101011
111111111111111101111111101111111101101011
100000100010000100010000100000000100001011
101110111010111110111110111111111110101011
101000100000000010000000000000000010001011
101011111111111010111111111111101111101011
100000000000001000000000000000100010001011
101111111111101111111111111111101010111011
100010000010100000000010000000000010000011
101110101110101111111010111111111110101011
101000100000101000000010100000000000101011
101011111111101011111110101111111111101011
100010000000001010000000000000000000101011
101011111111111011111111111111111111101011
100010000000000000000000000000000000001011
101011111110111111111110111111111111101011
100000000010000000000010000000000000001C11
101111101011111111111010111111111110101011
100000101010000000000010000000001010001011
111101111110111111111110101111111110101011
1E0000000000100000000000100000000000000011
111111111111111111111111111111111111111111
