111111
1C0001
1000P1
1E0001
111111