111111
1C0001
1100P1
1E0001
111111